







....................
..................R.
..................R.
..................R.
........RRR.......R.
..P...............R.
RRRRRRRRRRRRRRRRRRRR